178 178 178 178 178 178 157 121 159 178 178 178 178 178 178 178 178 178 178 178 178 178 178 178 178 178 178 178 178 178 178 178 178 178 178 178 178 178 178 178 178 178 178 178 178 178 178 178 178 178
178 178 178 178 178 178 157 121 159 178 178 178 178 178 178 178 178 178 178 178 178 178 178 178 178 178 178 178 178 178 178 178 178 178 178 178 178 178 178 178 178 178 178 178 178 178 178 178 178 178
178 178 178 178 178 178 157 121 159 178 178 178 178 178 178 178 178 178 178 178 178 178 178 178 178 178 178 178 178 178 178 178 178 178 178 178 178 178 178 178 178 178 178 178 178 178 178 178 178 178
178 178 178 178 178 178 157 122 159 178 178 178 178 178 178 178 178 178 178 178 178 178 178 178 178 178 178 178 178 178 178 178 178 178 178 178 178 178 178 178 178 178 178 178 178 178 178 178 178 178
178 178 178 178 178 178 157 121 159 178 178 178 178 178 178 178 178 178 178 178 178 178 178 178 178 178 178 178 178 178 178 178 178 178 178 178 178 178 178 178 178 178 178 178 178 178 178 178 178 178
178 178 178 178 178 178 157 121 159 178 178 178 178 178 178 178 178 178 178 178 178 178 178 178 178 178 178 178 178 178 178 178 178 178 178 178 178 178 178 178 178 178 178 178 178 178 178 178 178 178
178 178 178 178 178 178 157 123 168 150 150 150 150 150 150 150 151 178 178 178 178 178 178 178 178 141 143 141 141 141 143 141 141 141 141 141 141 149 150 150 150 151 178 178 178 178 178 178 178 178
178 178 178 178 178 178 157 121 132 110 110 110 110 110 110 110 148 178 178 178 178 178 178 178 178 141 141 141 142 141 141 141 178 178 178 178 178 147 110 112 110 148 178 178 178 178 178 178 178 178
178 178 178 178 178 178 157 121 132 112 110 110 110 110 110 111 148 178 178 178 178 178 178 178 178 142 141 141 141 141 141 141 178 178 178 178 178 147 110 179 110 148 178 178 178 178 178 178 178 178
178 178 178 178 178 178 157 121 132 110 110 110 110 110 112 110 148 178 178 178 178 178 178 178 178 141 141 141 143 141 142 141 178 178 178 178 178 147 112 110 110 148 178 178 178 178 178 178 178 178
178 178 178 178 178 178 157 122 132 111 110 110 112 110 110 110 148 178 178 178 178 178 178 178 178 141 143 141 141 141 141 141 178 178 178 178 178 230 179 179 111 148 178 178 178 178 178 178 178 178
178 178 178 178 178 178 157 121 132 110 110 110 110 179 110 112 148 178 178 178 178 178 178 178 178 143 141 141 141 141 141 141 178 178 178 178 178 230 179 110 110 148 178 178 178 178 178 178 178 178
178 178 178 178 178 178 157 123 132 110 112 110 110 111 110 110 134 150 150 150 150 150 150 150 151 141 141 141 143 141 141 141 178 178 178 178 178 231 144 144 140 148 178 178 178 178 178 178 178 178
178 178 178 178 178 178 157 121 132 110 110 110 110 110 110 112 110 111 110 110 110 112 110 110 148 141 141 141 141 142 141 141 178 178 178 178 178 178 178 178 147 148 178 178 178 178 178 178 178 178
178 178 178 178 178 178 157 121 132 138 144 144 144 144 144 144 144 144 144 144 144 144 144 144 146 142 141 142 141 141 141 141 178 178 178 178 178 178 178 178 147 148 178 178 178 178 178 178 178 178
178 178 178 178 178 178 157 121 132 136 178 178 178 178 178 178 178 178 178 178 178 178 141 141 141 141 141 141 141 141 143 141 141 178 178 178 178 178 178 178 147 148 178 178 178 178 178 178 178 178
178 178 178 178 178 178 157 121 132 136 178 178 178 178 178 178 178 178 178 178 178 178 143 141 142 141 141 143 141 141 141 141 141 178 178 178 178 178 142 141 145 146 178 178 178 178 178 178 178 178
178 178 178 178 178 178 157 122 132 136 178 178 178 178 178 178 178 178 178 178 178 178 141 141 141 141 141 141 141 141 142 141 141 178 178 178 178 178 141 141 178 178 178 178 178 178 178 178 178 178
178 178 178 178 178 178 157 121 132 136 178 178 178 178 178 178 178 178 178 178 178 178 141 141 141 143 141 141 141 141 141 141 141 178 178 178 178 178 142 141 178 178 178 178 178 178 178 178 178 178
178 178 178 178 178 178 157 121 132 134 133 133 133 133 133 133 151 178 178 178 178 178 141 141 141 141 141 141 141 143 141 141 143 178 178 178 178 141 141 143 141 178 178 178 178 178 178 178 178 178
178 178 178 178 178 178 157 122 124 131 131 131 131 131 131 120 148 178 178 178 178 178 142 141 141 141 141 141 142 141 141 141 141 178 178 178 141 142 141 141 141 141 178 178 178 178 178 178 178 178
178 178 178 178 178 178 157 121 123 122 121 123 122 121 121 132 148 178 178 178 178 178 141 141 142 141 141 141 141 141 141 143 141 178 178 178 143 141 141 141 142 141 178 178 178 178 178 178 178 178
178 178 178 178 178 178 161 181 182 113 113 113 113 128 123 132 148 178 178 178 178 178 143 141 141 141 143 141 141 141 142 141 141 178 178 178 141 141 143 141 141 143 178 178 178 178 178 178 178 178
178 178 178 178 178 178 178 178 145 144 140 111 112 116 121 132 134 133 133 151 178 178 141 142 141 141 141 141 141 141 141 141 141 178 178 178 142 141 141 142 141 141 178 178 178 178 178 178 178 178
178 178 178 178 178 178 178 178 141 141 145 140 112 116 122 124 131 131 120 148 178 178 141 141 141 141 141 141 141 143 141 141 143 178 178 178 178 178 141 141 141 141 178 178 178 178 178 178 178 178
178 178 178 178 178 178 178 178 141 141 141 145 140 116 121 121 122 121 132 134 133 151 141 141 141 143 141 141 141 141 141 141 141 178 178 178 178 178 178 178 178 141 178 178 178 178 178 178 178 178
178 178 178 178 178 178 178 178 141 141 141 141 137 114 113 113 128 123 124 131 131 169 158 158 158 158 158 158 158 170 174 174 171 158 158 167 178 178 178 178 178 142 178 178 178 178 178 178 178 178
178 178 178 178 178 178 178 178 141 141 141 141 145 144 144 144 183 121 122 121 123 121 121 122 123 121 121 122 121 173 174 174 172 121 121 159 178 178 178 178 178 141 178 178 178 178 178 178 178 178
178 178 178 178 178 178 178 178 141 141 141 141 141 141 141 141 161 160 160 160 160 160 160 160 160 160 160 160 160 176 174 174 175 180 122 159 178 178 178 178 178 141 178 178 178 178 178 178 178 178
178 178 178 178 178 178 178 178 141 141 141 141 141 141 141 141 141 141 141 141 141 141 141 141 141 141 141 141 141 141 141 141 141 157 123 159 178 178 178 178 178 142 178 178 178 178 178 178 178 178
178 178 178 178 178 178 178 178 141 141 141 141 141 141 141 141 192 185 185 185 185 185 185 185 185 185 185 185 185 185 185 185 185 226 121 159 178 178 178 178 178 142 178 178 178 178 178 178 178 178
178 178 178 178 178 178 178 178 141 141 141 141 141 141 141 141 188 184 203 190 190 190 190 190 204 184 184 184 184 184 184 184 184 214 122 159 178 178 178 178 141 141 143 178 178 178 178 178 178 178
178 178 178 178 178 178 178 178 141 141 141 141 141 141 141 141 188 184 187 141 141 141 141 141 188 184 184 184 184 184 184 184 184 214 121 152 158 158 158 158 170 174 171 158 158 158 158 158 158 158
178 178 178 178 178 178 178 178 141 141 141 141 141 141 141 141 188 184 187 141 141 141 141 141 191 190 204 184 184 184 184 184 203 227 121 122 123 121 122 121 173 174 172 123 121 122 121 123 121 121
178 178 178 178 178 178 178 178 141 141 141 141 141 141 141 141 191 190 189 141 178 178 141 141 141 141 191 229 229 229 229 229 189 161 160 160 160 160 160 160 176 174 175 232 232 232 232 232 232 232
178 178 178 178 178 178 178 178 141 141 141 141 141 141 141 141 141 141 141 141 178 178 141 141 141 141 178 178 178 178 178 178 178 178 178 178 178 178 178 178 142 141 141 178 178 178 141 178 178 178
178 178 178 178 178 178 178 178 141 141 141 141 141 141 141 141 141 141 141 141 178 178 178 178 141 141 178 178 178 178 178 178 178 178 178 178 178 178 178 178 178 178 141 141 141 141 141 178 178 178
178 178 178 178 178 178 178 178 141 141 141 141 141 141 141 141 141 141 141 141 178 178 178 178 141 141 141 178 178 178 178 178 178 178 178 178 178 178 178 178 178 178 178 178 178 178 178 178 178 178
178 178 178 178 178 178 178 178 141 141 141 141 141 141 141 141 141 141 141 141 178 178 178 178 141 141 141 178 178 178 178 178 178 178 178 178 178 178 178 178 178 178 178 178 178 178 178 178 178 178
178 178 178 178 178 178 178 178 141 141 141 141 141 141 141 141 141 141 141 141 178 178 178 178 141 141 141 178 178 178 178 178 178 178 178 178 178 178 178 178 178 178 178 178 178 178 178 178 178 178
178 178 178 178 178 178 178 178 141 141 141 141 141 141 141 141 141 141 141 141 178 178 178 178 141 141 141 178 178 178 178 178 178 178 178 178 178 178 178 178 178 178 178 178 178 178 178 178 178 178
178 178 178 178 178 178 178 178 141 141 141 141 141 141 141 141 141 141 141 141 178 178 178 178 141 141 141 178 178 178 178 178 178 178 178 178 178 178 178 178 178 178 178 178 178 178 178 178 178 178
178 178 178 178 178 178 178 178 141 141 141 141 141 141 141 141 141 141 141 141 178 178 178 178 141 141 141 178 178 178 178 178 178 178 178 178 178 178 178 178 178 178 178 178 178 178 178 178 178 178
178 178 178 178 178 178 178 178 141 141 141 141 141 141 141 141 141 141 141 141 178 178 178 178 141 141 141 178 178 178 178 178 178 178 178 178 178 178 178 178 178 178 178 178 178 178 178 178 178 178
178 178 178 178 178 178 178 178 178 178 178 178 178 178 178 178 178 178 178 178 178 178 178 178 178 178 178 178 178 178 178 178 178 178 178 178 178 178 178 178 178 178 178 178 178 178 178 178 178 178
178 178 178 178 178 178 178 178 178 178 178 178 178 178 178 178 178 178 178 178 178 178 178 178 178 178 178 178 178 178 178 178 178 178 178 178 178 178 178 178 178 178 178 178 178 178 178 178 178 178
178 178 178 178 178 178 178 178 178 178 178 178 178 178 178 178 178 178 178 178 178 178 178 178 178 178 178 178 178 178 178 178 178 178 178 178 178 178 178 178 178 178 178 178 178 178 178 178 178 178
178 178 178 178 178 178 178 178 178 178 178 178 178 178 178 178 178 178 178 178 178 178 178 178 178 178 178 178 178 178 178 178 178 178 178 178 178 178 178 178 178 178 178 178 178 178 178 178 178 178
178 178 178 178 178 178 178 178 178 178 178 178 178 178 178 178 178 178 178 178 178 178 178 178 178 178 178 178 178 178 178 178 178 178 178 178 178 178 178 178 178 178 178 178 178 178 178 178 178 178
178 178 178 178 178 178 178 178 178 178 178 178 178 178 178 178 178 178 178 178 178 178 178 178 178 178 178 178 178 178 178 178 178 178 178 178 178 178 178 178 178 178 178 178 178 178 178 178 178 178